7,7,2
1,0,0,0,0,0,0
3,3,3,3,4,4,4
3,4,4,3,3,3,3
3,4,4,4,4,4,3
3,3,3,3,3,3,3
4,4,4,4,4,4,3
0,0,0,0,0,0,2
0,28,34,48
0,7,10,17,20,48